Oligonucleotide name	sequence (5'-3')
Oligo dT-anchor RT primer       	GACCACGCGTATCGATGTCGACTTTTTTTTTTTTTTTTV
PCR universal anchor primer	GACCACGCGTATCGATGTCGAC
GAPDH	TCCTCACAGTTGCCATGTAGAC
STMN2_canonical	CGCAGTTTTGAAGTCGTTTCTCC
STMN2_ALE	GTGGCACAGTTGACAAGGATGA
SYNJ2_canonical	GCTGCAAAGATTATTGGGGGACT 
SYNJ2_ALE	AAGGACTTTGAAGAATCGAGTGAC 
ARHGAP32_canonical	AAAGCAAATGTCCCACTGAAAGTG
ARHGAP32_ALE_short	GCATTTGGCTGGTTTGTTAGATGG
ARHGAP32_ALE_long	TGGCATGGTGTTAGGACTAAACAG
PHF2_canonical	ACCTGGACATCAAGCTGTTCTC 
PHF2_ALE_short	GTAGATGAATGGATGAATGGATGG
PHF2_ALE_long	GGATGAGCAAATGGATGGATGG 
ELK1_canonical	GGGACAGTGCTACACTCGTC
ELK1_3'Ext	AGCCTTATGTTATCAGAGAACAGAG
TLX1_canonical	CATTTCTCCAGAACCCATTTGAGG
TLX1_3'Ext	TGTGTGACTGCTTCTGAAGTGG
SIX3_canonical	GCAGCTTCAGAGGTATCTCTCAC
SIX3_3'Ext	GTGTTTGTTGTGGGTGTGTAGATG
SIN3B_canonical	GTTCTGGGGCTTGTCCTTCC 
SIN3B_IPA	TGCTGTGTGAGCCCTTTTGC
CNPY3_canonical	CTCACCATCCCTCAGTCCTC 
CNPY3_IPA	AAGGGAATAGTCTCAAGCAGCAG 
ANKRD27_canonical	TGACCTTGTGATAGGGAAATGGT 
ANKRD27_IPA	CAGGAGTTGGAGACCAGTGTG 
GAPDH_FW	CACCAGGGCTGCTTTTAACT
GAPDGH_RV	GACAAGCTTCCCGTTCTCAG
Pre GAPDH_RV	GGGGAATACGTGAGGGTATG
STMN2 Cryptic FW	GCTCTCTCCGCTGCTGTAG
STMN2 Cryptic RV	CTGTCTCTCTCTCTCGCACA